11111111111111111
1C0000C00000001E1
10000111111000101
1001000011100C001
1P0100000C0000001
11111111111111111