11111111111111111
100000000000001E1
111111111110001011
10000000111000001
1P010000000000C01
11111111111111111