11111111111111111
1C0M00C00000M01E1
10000111111000101
10010000111M0C001
1P0100M00C00000M1
11111111111111111