1111111111111
1C00000000001
1110000000101
1P000000001E1
1111111111111
